XXIII: LSR
LVII: RKH
IX: XYU
LXXVIII: ZKI
LXXXV: WCV
LIII: EWO
LXXVII: PRR
LXXII: RNN
V: SPZ
XIII: TZE
XCIII: MQD
VI: POC
LXXXII: RCY
XXVII: ZNN
LXXXIX: QIL
XLI: XDF
XXVI: KFS
XV: CKI
XXXIII: JRO
LXXIII: ISW
XVIII: BPC
XX: NQL
XXXIX: ERF
XCI: EWC
II: TRU
VII: GGH
LXIX: AVJ
XXIX: TFS
LXXXVII: DMI
LXXI: RWF
LV: PJT
XXXV: AQX
XLII: DQH
XXXVIII: EGM
LXXXIII: TOL
XL: UHH
XLIII: RBL
XXXVII: YKU
XXV: LKN
IV: VUJ
LXXIV: DDJ
LXXXVIII: PWL
XCVI: VEV
I: OGP
XLIV: XTF
XLV: MNO
XXI: SAB
LXXXVI: WQG
VIII: TYN
X: TED
XXX: PRI
XCIV: LXP
XVII: CVN
XIX: PYL
LXV: POR
XXXI: NEB
XI: MXV
LXXIX: PRZ
III: TSF
L: SFM
LVI: WAT
LXXV: MZP
LXX: SAU
XXIV: CNX
XCIX: VRM
XII: ZAE
XIV: MWT
LXIV: VAQ
LXXXI: ZBE
XCVIII: DKT
LXIII: HDR
XC: CCQ
LIV: OKS
XXXIV: BDJ
LXII: MPN
XCVII: YOY
XLIX: HWE
LXVII: CQH
XLVI: QPG
LX: HVR
XCII: UWR
XCV: OOI
XLVII: KUC
LXI: LOA
LXXX: GTD
LIX: SFZ
XXXVI: DZU
LXVI: HQQ
LXVIII: WLD
XXVIII: RGU
LI: KMI
LII: WXZ
XXII: MOG
XVI: FUP
LXXVI: GTM
XLVIII: NXT
XXXII: YYS
LVIII: HUQ
LXXXIV: HPR
